..................................
...####################......#....
......#....#.........##......#.Z..
......#....#.........#############
......#....#######...#.......#....
.....................#.......#####
...##############....#............
...........#.........#............
######.....#.........#.....#######
.....#.....#.....................#
.....###################.....#####
..................................
..................................
...##############....#............
...........#.........#............
######.....#.........#.....#######
.....#.....#..................#...
...###...###############......#...
..............................#...
..A...............................
